15 15
W W W W W W W W W W W W W W W
W F F F F F F F F F F F F F W
W F F F F F F F F F F F F F W
W F F D F F F F F F F F F F W
W F F F F F F F F F D F F F W
W F F F F F F F F D F F F F W
W F F F F F F F F F F F F F W
W F F F F F D F F F F F F F W
W F F F F F F F F F F F F F W
W F F F F F F F F F F F F F W
W F F F F F F F F F F F F F W
W F F F F F F F F F F F F F W
W F F D F F F F F F F F F F W
W F F F F F F F F F F F F F W
W W W W W W W W W W W W W W W